WWWWWWWWWWWSWWWWWWWW
W W       W W   W  W
W   WWWWWWW W W   WW
W WWW     W WWWWW WW
W     W W W        W
W W W W W WWWWWW W W
W W W W W W W    W W
W W W W W W WWWW W W
W W W W W   W    W W
W W W WWWW WWWWW W W
W W W   W        W W
W W WWWWWWWWWWWWWW W
W W W        W   WWW
W W WWWWWWWW WW    W
W W W           WWWW
W WWW WWWWWWWWW  W W
W             WW W W
WWWWWWWWWWWWWWW  W W
W                  W
WEWWWWWWWWWWWWWWWWWW